OOOOOOOOOOOOOOOOOOOOOOOOOOOOOOOO
OXEXXXXXXXXXXXXXXXXXXXXXXXXXXEXO
OX-OOOOOOOOOOOOOOOOOOOOOOOOOO-XO
OXOXXXXXXXXXXXXXXXXXXXXXXXXXXOXO
OXOX-OOOOOOOOOOOOOOOOOOOOOO-XOXO
OXOXOXXXXXXXXXXXXXXXXXXXXXXOXOXO
OXOXOXXXXXXXXXXXXXXXXXXXXXXOXOXO
OXOXOXXXXXXXXXXXXXXXXXXXXXXOXOXO
<XOXOXXXXXXXXXXXXXXXXXXXXXXOXOX>
<XOXOXXXXXXXXXXXXXXXXXXXXXXOXOX>
<XOXOXXXXXXXXXXXXXXXXXXXXXXOXOX>
OXOXOXXXXXXXXXXXXXXXXXXXXXXOXOXO
OXOXOXXXXXXXXXXXXXXXXXXXXXXOXOXO
OXOX-OOOOOOOOOOOOOOOOOOOOOO-XOXO
OXOXXXXXXXXXXXXXXXXXXXXXXXXXXOXO
OX-OOOOOOOOOOOOOOOOOOOOOOOOOO-XO
OXEXXXXXXXXXXXXXXXXXXXXXXXXXXEXO
OOOOOOOOOOOOOOOOOOOOOOOOOOOOOOOO